11
19
4
0
###################
#####   ###########
#####   ###########
#####   ###########
###  $ $ ##########
### # ## ##########
#   # ## #####    #
# $  $          ..#
##### ### #@##  ..#
#####     #########
###################