17
17
10
#################
######     #   ##
#####  #  . $  ##
#####  # .## $ .#
#  ## ##  ##    #
#   .   #$# .   #
# $  $     . $$##
# #    ##       #
#   #######     #
#   #.####     ##
#  #  ####     ##
#  #  ###   #   #
#  # $####     ##
#    $ .##    @##
#     ##    $  ##
#.    ###.      #
#################
