11
11
7
###########
#    .   ##
# . $ $  .#
#  $      #
#    . $  #
###  @$ .##
#####  $  #
#####    ##
####. $ ###
#######.###
###########
