7
7
3
0
#######
#@#   #
#.  $ #
#   $ #
#  $  #
#   ..#
#######
