17
17
9
#################
##  .############
#  $ # ##########
#      # ########
##        #######
###. ###  #######
#   $     #######
#    $    #######
#.  .   $ .######
# $$ @#   ### ###
#         #.  ###
#  $ .   $    ###
# ####  .      ##
#.####          #
#######     $   #
#######        ##
#################
