17
17
10
0
#################
#### .#####.    #
### $ #  ##  #  #
##      #.#    ##
##        #  #$##
#   $ .         #
# .     $     . #
#@   #   $  $ . #
## $    $    $  #
#               #
#  #####     . .#
#  #####.#      #
#  ########   $ #
#  ########     #
## ######       #
##############  #
#################
