11
11
3
###########
#  #.#.#  #
##  $##   #
###  #    #
###. # $  #
# #$      #
#   ##    #
#   ##    #
# @       #
#         #
###########
