17
17
6
#################
########.       #
########     #  #
########$       #
######     $$  .#
#######   .     #
###########     #
############    #
###########.$  ##
############  $##
############  #.#
############@ $.#
###########     #
###########     #
###########     #
############    #
#################
