11
11
7
0
###########
#      .  #
#  # $$   #
#  #    $ #
#   . .   #
# #. $    #
#  #$#   @#
# $$  .  .#
#  # ## ###
##.# ######
###########
