17
17
11
0
#################
###########.#####
########### #####
########## $$ .##
#####   .    ####
####        $#.##
##     $     $  #
#  .         $  #
#     $  .     ##
#  $#      @.   #
#    #   $      #
#     .    $  # #
#  ##           #
#  ##     #.  ###
#  #. $ #########
##     .#########
#################
