17
17
9
0
#################
##############  #
##############  #
#############   #
##########  .@$ #
########## # $  #
#############   #
############ .  #
####   ###  .   #
#. $ .          #
#  $  ####$ $$  #
# $    .## .    #
#      ####. $  #
##    #######  ##
#############   #
###########.    #
#################
