7
7
3
#######
##.   #
#. $  #
#  $ .#
#  $@ #
#     #
#######
