11
11
4
###########
#       ###
# #    $.##
#   $    ##
#     $  ##
#    #..###
#    ######
#       ###
#    $@ ###
#   .## ###
###########
