7
7
4
0
#######
##  ..#
## $ @#
## $$ #
#. $  #
##   .#
#######
